Muse - Psycho
Graham Candy - Holding Up Balloons
Death Cab for Cutie - The Ghosts of Beverly Drive
Jason Derülo - Want to Want Me
Mumford & Sons - Believe
Olly Murs - Beautiful to Me
Snoop Dogg ft. Pharrell & Charlie Wilson - Peaches N Cream
Wiz Khalifa ft. Charlie Puth - See You Again
The Chainsmokers ft. Great Good Fine OK - Let You Go
Madonna ft. Chance the Rapper & Mike Tyson - Iconic
Coleman Hell - Thumbalina
Lord Huron - The World Ender
Handsome Ghost - Steps
Kodaline - Autopilot
Marina and the Diamonds - Forget
Sam Smith - Lay Me Down
Skylar Grey - Addicted to Love
Laura Welsh - Break the Fall
Conrad Sewell - Hold Me Up
The Wombats - Give Me A Try
All Time Low - Kids In The Dark
Christine and the Queens - Tilted
The Japanese House - Still
Madeon - Home
Big Data - Get Some Freedom ft. Dragonette
AWOLNATION - Run
La+ch - Tastey
Holly Miranda - All I Want is to Be Your Girl
Best Coast - Heaven Sent
Pell - Runaway (Remix) ft. White Sea
Empire Cast - Keep It Movin' ft. Serayah McNeil & Yazz
Nick Catchdubs - Full House ft. Troy Ave & Heems
MOD SUN - 1970
Joywave ft. Mick Jenkins & Little Simz - Bad Dreams
Kate Boy - Higher
VÉRITÉ - Wasteland
Sleeping With Sirens - Fly
Incubus - Trust Fall
Meg Myers - Sorry
Royal Tongues - The Balance
Speaker of the House - Human Contact (Speaker of the House Remix)
The Knocks - Dancing With Myself
Morgan Page ft. Lissie - Open Heart
Diego Boneta - The Warrior
Andrew Combs - Nothing to Lose
Striking Matches - Make a Liar Out of Me
Van Morrison - Irish Heartbeat
Brothers Osborne - Stay A Little Longer
Luke Bryan - Like We Ain't Ever
Cam - Burning House
Anderson East - Satisfy Me
Tobias Jesso Jr. - Without You
Matthew E. White - Holy Moly
The Amazing - Circles
The Bright Light Social Hour - Dreamlove